111111111111111111111
1000000C0000001000001
101011111100000010C01
11C0101000C0101100E01
101000C00100000101001
101011010P01010100101
1001100C0101001101011
100C10100000101001001
101010C1C111101101101
100000100001C00000001
111111111111111111111