111111111111111111111
10110000000C000000001
10100000C11011C101101
11000000010001000C101
101000C00000000000001
10010CCC00000000000P1
101000C00000000000101
1100000EN000000000001
10100000010001000C101
10000010C11011C101101
10100000000C000000001
111111111111111111111