11111111111111111111111111
10100000000000000000000001
101C1000000000110P1CCCC101
10001110100001100001CCC101
1011000011001100C1C01CC101
100010N0011C1C00111001C101
10C0110000111110C1C0001101
1CC0C100000C1C110000000001
10C01100000110011000000001
10E11000001100001100000001
10110000011000000000000001
11111111111111111111111111